{ 21, 21, 21, 21, 21, 21, 25, 25, 25, 25, 25, 25, 25, 25, 25, 25,
21, 25, 25, 25, 25, 25, 25, 21, 21, 21, 21, 1, 21, 21, 21, 21,
25, 25, 21, 21, 21, 21, 21, 21, 41, 41, 41, 41, 41, 41, 41, 41,
21, 25, 21, 21, 1, 21, 41, 41, 41, 21, 25, 25, 25, 21, 21, 21,
21, 25, 25, 21, 41, 41, 41, 21, 21, 21, 25, 25, 25, 1, 21, 21,
21, 21, 25, 21, 41, 21, 1, 1, 21, 21, 25, 25, 25, 25, 1, 21,
1, 21, 25, 21, 41, 21, 1, 1, 1, 21, 25, 25, 25, 25, 25, 25,
21, 21, 25, 21, 41, 1, 1, 1, 21, 21, 21, 21, 25, 25, 25, 25 }